000000000000020000000000000000
000000001110020000000001000000
000000001110020020000011110000
000000001110020020000011111000
000000000000022222000001111000
000000000000220002000001110000
000000000000200002000000000000
000001000000200002000000000000
000001110000200000000000000000
000001110000200000111000000000
000001100002200001111000000000
000000000002000011111000000000
000000000002000011111100000000
000000222222000001111000000000
000000200002222000100000000000
000000200000002000000000000000
000000200000002222000000002222
000000000000000002000000002000
000000000000000002000000222000
000000000000000222000000200000